1111111111111111111111
1010001011101110101111
101C101011111111111011
1000000P000*0000000001
1011101011111010111001
1111111011101000001001
100011101111101C111001
10101010*1111110101001
1110111010001010111001
1000C00C1010*00000C0E1
1111111111111111111111