1111111111111111111111
1010001011101110101111
101C101011111111111011
1000000P000*0000001111
1011101011111010111011
1111111011101000001011
100011101111101C111011
10101010*1111110101011
1110111010001010111011
1000C00C1010*00000C0E1
1111111111111111111111