1111111111
1010E11111
100100CC01
110011E0P1
1000000001
1000000001
1000000001
1000000001
1000000001
1000000001
1000000001
1000000001
1000000001
1000000001
1000000001
1000000001
1000000001
1000000001
1000000001
1000000001
1000000001
1000000001
1000000001
1000000001
1000000001
1000000001
1000000001
1000000001
1000000001
1000000001
1111111111