111111111111
1010E1111101
100100CC0001
110011E0P001
100000000001
111111111111